%%%%%%%%%%%%%
%     %     %
%%       % %%
%   % %     S
%%          %
% % %     % %
%        %  %
%       %   %
%  % %      %
%        T% %
%%       %  %
%       %   %
%%%%%%%%%%%%%
