%%%%%%%%%%%%%%%%%%%%%
%           %   % % %
%G%%% %%% % % %%% % %
S %       %  T      %
%%%%% %%% %%%%% % % %
% %   % %   %       %
% % % % %%% %%%%%%% %
% %   %   %   %    K%
% % % % % %%% % %%% %
%     % %      T    %
%%%%% %%% % % %%% % %
%   %         %     %
% % % % %%% %%% % %%%
% %   %             %
% %%% %%%%%%% % %%% %
% %                 %
% %%% % % %%% % % % %
%   % %     % % %   %
% %%% % % % % % % % %
%       %   % % % % %
%%%%%%%%%%%%%%%%%%%%%
