%%%%%%%%%%%%%%%%%
% % %T%   %     %
% % % % % % % %%%
%               %
% %%%%%%% % % % %
%       % %     %
%%% % %%% % % % %
%     % %       %
% % % % % % % % %
%T  %           %
%%% % %%%%% % % %
%   %   %   %   %
% % % % % % % %%%
% % % %         %
% % %%%%%%%%%G% %
% %    K      % %
%%%%%%%%%%%S%%%%%
