%%%%%%%%%%%%%%%%%%%%%
%                   %
% %%%%%%%%% % %%% %%%
%K%       %   %     %
% % %%% %%%%%%% % % %
%       %   %    T% %
% % %%% % %%% %%% % %
% %   % % % % %   % %
% % % % % % % %%% % %
%  T%         %     %
%%%%%%%%% % % % %%%%%
%   %     % % %     %
%%% % % % % % % % % %
%         %   % % % %
% %%% % % %%% % % % %
% %   % % %         %
% % %%% % % % %%% %%%
%     %   %     %   %
% % % % %G% % % % % %
%       %       % % %
%%%%%%%%%%%S%%%%%%%%%
