+---+---+---+---+---+---+
|       |               |
+   +---+   +   +   +   +
| T |       |   | P |   |
+   +   +---+   +---+---+
|       |           |   |
+---+---+   +---+   +   +
  E     G   |     K     |
+   +   +---+   +---+   +
|   |   | T |   | T |   |
+   +---+   +   +   +   +
|   |           |       |
+---+---+---+---+---+---+
